4 24 31
           IPITVT KK  K K KK   #
           PPPTVT K K K K K K  #
     SSS   IPITVT K K KKK K K  #
    S   S     TVT K K K K K K  #
   S 4S  S    TVT KK  K K KK   #
   S SPS S    TVT       p      #
   S  S  S    TVT J  J JJJ JJJ #
    S   S     TVT J  J J    J  #
GSG  SSS   HSHTVT J  J JJJ  J  #
SSS        SSSTVT J  J J    J  #
GSGNNNNNNNNHSHTVT  JJ  JJJ  J  #
TTTTTTTTTTTTTTTVTTTTTTTTTTTTTTT
UUUUUUUUUUUUUUUTUUUUUUUUUUUUUUU
TTTTTTTTTTTTTTTVTTTTTTTTTTTTTTT
AAAAA    BBBBBTVTPPPPPPPPPPPPPP#
A1 1A    B 4 BTVTP            P#
A1 1A    B   BTVTP PPPPPPPPPP P#
A1 1A    B   BTVTP Pcc  P   P P#
A1 1A    B   BTVTP PccP   P P P#
A1x1A    B   BTVTP PPPPPPPP P P#
A1 1A    B   BTVTP          P P#
A1 1A    B   BTVTPPPPPPPPPPPP P#
A1 1A    B   BTVT             P#
AAAAA    BBBBBTVTPPPPPPPPPPPPPP#
################################